[3]
[4,  5]
[5,  6,  7]
[7,  8,  9,  11]
[8,  9,  10, 12, 13]
[10, 11, 12, 14, 15, 17]
[11, 12, 13, 15, 16, 18, 19]
[13, 14, 15, 17, 18, 20, 21, 23]
[16, 17, 18, 20, 21, 23, 24, 26, 29]
[17, 18, 19, 21, 22, 24, 25, 27, 30, 31]
[20, 21, 22, 24, 25, 27, 28, 30, 33, 34, 37]
[22, 23, 24, 26, 27, 29, 30, 32, 35, 36, 39, 41]
[23, 24, 25, 27, 28, 30, 31, 33, 36, 37, 40, 42, 43]
[25, 26, 27, 29, 30, 32, 33, 35, 38, 39, 42, 44, 45, 47]
[28, 29, 30, 32, 33, 35, 36, 38, 41, 42, 45, 47, 48, 50, 53]
[31, 32, 33, 35, 36, 38, 39, 41, 44, 45, 48, 50, 51, 53, 56, 59]
[32, 33, 34, 36, 37, 39, 40, 42, 45, 46, 49, 51, 52, 54, 57, 60, 61]
[35, 36, 37, 39, 40, 42, 43, 45, 48, 49, 52, 54, 55, 57, 60, 63, 64, 67]
[37, 38, 39, 41, 42, 44, 45, 47, 50, 51, 54, 56, 57, 59, 62, 65, 66, 69, 71]
[38, 39, 40, 42, 43, 45, 46, 48, 51, 52, 55, 57, 58, 60, 63, 66, 67, 70, 72, 73]
[41, 42, 43, 45, 46, 48, 49, 51, 54, 55, 58, 60, 61, 63, 66, 69, 70, 73, 75, 76, 79]
[43, 44, 45, 47, 48, 50, 51, 53, 56, 57, 60, 62, 63, 65, 68, 71, 72, 75, 77, 78, 81, 83]
[46, 47, 48, 50, 51, 53, 54, 56, 59, 60, 63, 65, 66, 68, 71, 74, 75, 78, 80, 81, 84, 86, 89]
[50, 51, 52, 54, 55, 57, 58, 60, 63, 64, 67, 69, 70, 72, 75, 78, 79, 82, 84, 85, 88, 90, 93, 97]